==============	Pre-negados	===========================================
descartaron al paciente contra	[pre-negation]
sin antecedentes conocidos de	[pre-negation]
ningún cambio significativo	[pre-negation]
descartaron al paciente por	[pre-negation]
descartó al paciente contra	[pre-negation]
descartar al paciente por	[pre-negation]
lo descartaron en contra	[pre-negation]
debe ser descartado para	[pre-negation]
sin ninguna evidencia de	[pre-negation]
adecuado para descartar	[pre-negation]
ninguna nueva evidencia	[pre-negation]
debe ser descartado por	[pre-negation]
sin cambio de intervalo	[pre-negation]
expulsó al paciente por	[pre-negation]
se puede descartar por 	[pre-negation]
ninguna evidencia para	[pre-negation]
ninguna otra evidencia	[pre-negation]
ninguna sugerencia de	[pre-negation]
debe descartarse para	[pre-negation]
descartar al paciente	[pre-negation]
debe descartarse para	[pre-negation]
gobierna al paciente	[pre-negation]
ninguna evidencia de	[pre-negation]
sin que se observara	[pre-negation]
sin grandes cambios	[pre-negation]
sin que se observen	[pre-negation]
sin alteraciones de	[pre-negation]
sin alteraciones en	[pre-negation]
no hay evidencia de	[pre-negation]
sin antecedentes de	[pre-negation]
sin que se aprecien	[pre-negation]
será descartado por	[pre-negation]
ser descartado por	[pre-negation]
descartaron contra	[pre-negation]
lo descartaron por	[pre-negation]
nunca desarrollado	[pre-negation]
la descartaron por	[pre-negation]
lo descartó contra	[pre-negation]
obliga a descartar	[pre-negation]
lo descartó contra	[pre-negation]
sin poder detectar	[pre-negation]
la descartó contra	[pre-negation]
nada especial para	[pre-negation]
sin poder detectar	[pre-negation]
sin indicación de	[pre-negation]
sin hallazgos que	[pre-negation]
no existe toma de	[pre-negation]
ninguna evidencia	[pre-negation]
no se identifican	[pre-negation]
descartado contra	[pre-negation]
en ningún momento	[pre-negation]
sin evidencia de	[pre-negation]
descartaron para	[pre-negation]
ninguna señal de	[pre-negation]
se ha descartado	[pre-negation]
no significativo	[pre-negation]
no se identifica	[pre-negation]
no han permitido	[pre-negation]
sin hallazgos de	[pre-negation]
ninguna causa de	[pre-negation]
sin evidencia de	[pre-negation]
sin presencia de	[pre-negation]
descartarla por	[pre-negation]
descartarlo por	[pre-negation]
sin demostrarse	[pre-negation]
paciente no era	[pre-negation]
no se evidencia	[pre-negation]
no se objetivan	[pre-negation]
descartarlo por	[pre-negation]
descartarla por	[pre-negation]
no se objetivan	[pre-negation]
no se considera	[pre-negation]
no asociado con	[pre-negation]
descartarlo por	[pre-negation]
descartar para	[pre-negation]
sin dificultad	[pre-negation]
lo descartaron	[pre-negation]
negativas para	[pre-negation]
desapareciendo	[pre-negation]
no se observan	[pre-negation]
sin apreciarse	[pre-negation]
no se detectan	[pre-negation]
no se aprecian	[pre-negation]
no se producen	[pre-negation]
no objetivando	[pre-negation]
sin presentar	[pre-negation]
no se aprecia	[pre-negation]
sin respuesta	[pre-negation]
sin quejas de	[pre-negation]
negativa para	[pre-negation]
negativo para	[pre-negation]
ha descartado	[pre-negation]
no es posible	[pre-negation]
imposibilidad	[pre-negation]
sin objetivar	[pre-negation]
sin hallazgos	[pre-negation]
no se observa	[pre-negation]
no sospechoso	[pre-negation]
sin respuesta	[pre-negation]
ha descartado	[pre-negation]
no demostrar	[pre-negation]
no evidencia	[pre-negation]
más bien que	[pre-negation]
que descarta	[pre-negation]
no ha tenido	[pre-negation]
no signos de	[pre-negation]
se suspenden	[pre-negation]
se suspende	[pre-negation]
descartaron	[pre-negation]
retirada de	[pre-negation]
no objetiva	[pre-negation]
descartarla	[pre-negation]
negatividad	[pre-negation]
no presenta	[pre-negation]
no ausculto	[pre-negation]
lo descartó	[pre-negation]
negativo de	[pre-negation]
lo descarta	[pre-negation]
la descartó	[pre-negation]
ausencia de	[pre-negation]
descartarse	[pre-negation]
no saber de	[pre-negation]
se descarta	[pre-negation]
no apreciar	[pre-negation]
descartarlo	[pre-negation]
desaparece	[pre-negation]
negativo a	[pre-negation]
no procede	[pre-negation]
con ningún	[pre-negation]
la excluye	[pre-negation]
no refiere	[pre-negation]
no anormal	[pre-negation]
no exhibir	[pre-negation]
no existen	[pre-negation]
no realiza	[pre-negation]
nada nuevo	[pre-negation]
no revelar	[pre-negation]
no aprecia	[pre-negation]
no aparece	[pre-negation]
negativa a	[pre-negation]
no muestra	[pre-negation]
se retira	[pre-negation]
no existe	[pre-negation]
no sentir	[pre-negation]
no revela	[pre-negation]
no se ven	[pre-negation]
no mostró	[pre-negation]
descartar	[pre-negation]
desestima	[pre-negation]
se retira	[pre-negation]
suspender	[pre-negation]
no tenía	[pre-negation]
no tengo	[pre-negation]
no tiene	[pre-negation]
no vemos	[pre-negation]
falta de	[pre-negation]
descartó	[pre-negation]
descarto	[pre-negation]
libre de	[pre-negation]
no había	[pre-negation]
suspendo	[pre-negation]
descarto	[pre-negation]
retirar	[pre-negation]
tampoco	[pre-negation]
excluye	[pre-negation]
excluir	[pre-negation]
rechaza	[pre-negation]
no ser	[pre-negation]
no ver	[pre-negation]
no hay	[pre-negation]
evitar	[pre-negation]
no ha	[pre-negation]
nunca	[pre-negation]
niega	[pre-negation]
sin	[pre-negation]
no	[pre-negation]
ni	[pre-negation]
==============	Post-negados	===========================================
con resultado negativo	[post-negation]
que resultan negativas	[post-negation]
que resultan negativos	[post-negation]
sin cambio definitivo	[post-negation]
podría ser descartado	[post-negation]
que resulta negativo	[post-negation]
puede ser descartado	[post-negation]
han sido descartadas	[post-negation]
resultaron negativas	[post-negation]
resultaron negativos	[post-negation]
resultados negativos	[post-negation]
que resulta negativa	[post-negation]
que resulta negativo	[post-negation]
puede ser retirado	[post-negation]
resultado negativo	[post-negation]
ha sido descartado	[post-negation]
podría descartarse	[post-negation]
siendo descartado	[post-negation]
están descartadas	[post-negation]
resultó negativa	[post-negation]
resulto negativa	[post-negation]
resultó negativo	[post-negation]
resulto negativo	[post-negation]
fueron negativos	[post-negation]
fueron negativas	[post-negation]
se ha suspendido	[post-negation]
son negativos	[post-negation]
son negativas	[post-negation]
será descartado	[post-negation]
está descartado	[post-negation]
ser descartado	[post-negation]
fue descartado	[post-negation]
fue suspendido	[post-negation]
fue suspendida	[post-negation]
fue negativo	[post-negation]
fue negativa	[post-negation]
no valorable	[post-negation]
descartadas	[post-negation]
negativas	[post-negation]
negativos	[post-negation]
no positiva	[post-negation]
es negativo	[post-negation]
es negativa	[post-negation]
no positivo	[post-negation]
descartadas	[post-negation]
no se trató	[post-negation]
sin cambios	[post-negation]
descartados	[post-negation]
negativo	[post-negation]
negativa	[post-negation]
descartada	[post-negation]
no recuera	[post-negation]
descartado	[post-negation]
improbable	[post-negation]
suspendida	[post-negation]
suspendido	[post-negation]
ninguno	[post-negation]
ninguna	[post-negation]
==============	Termination terms	===========================================
con antecedentes de	[termination-term]
antecedentes de	[termination-term]
por el momento	[termination-term]
de acuerdo con	[termination-term] 
en comparación	[termination-term]
en comparacion	[termination-term]
etiología de	[termination-term]
secundario a	[termination-term]
razones para	[termination-term]
mientras que	[termination-term]
por lo tanto	[termination-term]
por lo cual	[termination-term]
y solamente	[termination-term]
que refiere	[termination-term]
siempre que	[termination-term]
de modo que	[termination-term]
sin embargo	[termination-term]
origen para	[termination-term]
orígenes de	[termination-term]
presentando	[termination-term]
exceptuando	[termination-term]
no obstante	[termination-term]
pues luego	[termination-term]
antes bien	[termination-term]
a pesar de	[termination-term]
puesto que	[termination-term]
por lo que	[termination-term]
unicamente	[termination-term]
con lo que	[termination-term]
únicamente	[termination-term]
por la que	[termination-term]
por el que	[termination-term]
conclusión	[termination-term]
aparte del	[termination-term]
conclusion	[termination-term]
causas de	[termination-term]
se decide	[termination-term]
aparte de	[termination-term]
motivo de	[termination-term]
por ahora	[termination-term]
inclusive	[termination-term]
es decir	[termination-term]
mientras	[termination-term]
al menos	[termination-term]
a la que	[termination-term]
debido a	[termination-term]	
presenta	[termination-term]
presentó	[termination-term]
obstante	[termination-term]
habiendo	[termination-term]
que cede	[termination-term]
que tras	[termination-term]
dado el	[termination-term]
dado la	[termination-term]
y desde	[termination-term]
refiere	[termination-term]
excepto	[termination-term]
incluso	[termination-term]
así que	[termination-term]
si bien	[termination-term]
dado su	[termination-term]
dada su	[termination-term]
todavía	[termination-term]
sin que	[termination-term]
fuentes	[termination-term]
tampoco	[termination-term]
razones	[termination-term]
a pesar	[termination-term]
esto es	[termination-term]
aunque	[termination-term]
ya que	[termination-term]
empero	[termination-term]
aunque	[termination-term]
porque	[termination-term]
previa	[termination-term]
previo	[termination-term]
por lo	[termination-term]
fuente	[termination-term]
siendo	[termination-term]
y ante	[termination-term]
por si	[termination-term]
salvo	[termination-term]
si no	[termination-term]
según	[termination-term]
segun	[termination-term]
razón	[termination-term]
razon	[termination-term]
según	[termination-term]
luego	[termination-term]
donde	[termination-term]
entre	[termination-term]
si no	[termination-term]
antes	[termination-term]
hasta	[termination-term]
y que	[termination-term]
y con	[termination-term]
, con	[termination-term]
, que	[termination-term]
salvo	[termination-term]
sino	[termination-term]
pues	[termination-term]
ante	[termination-term]
pero	[termination-term]
solo	[termination-term]
dado	[termination-term]
dada	[termination-term]
bajo	[termination-term]
tras	[termination-term]
y en	[termination-term]
y se	[termination-term]
y al	[termination-term]
pese	[termination-term]
aun	[termination-term]
aún	[termination-term]
así	[termination-term]
asi	[termination-term]
sin	[termination-term]
si	[termination-term]
no	[termination-term]
ni	[termination-term]
 - 	[termination-term]
;	[termination-term]
==============	Uncertainty	===========================================
cuadro clínico en línea con	[uncertainty]
puede ser descartado para	[uncertainty]
podría ser descartado por	[uncertainty]
orientación diagnóstica	[uncertainty]
sin cambios sospechosos	[uncertainty]
planteó la posibilidad	[uncertainty]
plantea la posibilidad	[uncertainty]
adelantar la hipótesis	[uncertainty]
cuadro clínico como en	[uncertainty]
abordo la cuestión de	[uncertainty]
no puede ser excluido	[uncertainty]
no se puede descartar	[uncertainty]
no estoy seguro de si	[uncertainty]
hacer una prueba por	[uncertainty]
no podemos descartar	[uncertainty]
sospecha clínica de	[uncertainty]
no hay evidencia de	[uncertainty]
puede corresponder	[uncertainty]	
no estoy seguro si	[uncertainty]
interpretado como	[uncertainty]
puede representar	[uncertainty]
no necesariamente	[uncertainty]
preferencialmente	[uncertainty]
se debe descartar	[uncertainty]
sin signos claros	[uncertainty]
todo apuntando a	[uncertainty]
se debe examinar	[uncertainty]
modelo sugerente	[uncertainty]
se entiende como	[uncertainty]
poco concluyente	[uncertainty]
genera preguntas	[uncertainty]
compatibles con	[uncertainty]
consistente con	[uncertainty]
puede deducirse	[uncertainty]
presumiblemente	[uncertainty]
no estoy seguro	[uncertainty]
podría tratarse	[uncertainty]
consideraciones	[uncertainty]
si se confirma	[uncertainty]
no se extiende	[uncertainty]
podría deberse	[uncertainty]
contradictorio	[uncertainty]
tengo dudas de	[uncertainty]
examinado para	[uncertainty]
compatible con	[uncertainty]
se cree que es	[uncertainty]
potencialmente	[uncertainty]
percibido como	[uncertainty]
se siente como	[uncertainty]
incertidumbre	[uncertainty]
aparentemente	[uncertainty]
sin evidencia	[uncertainty]
sin descartar	[uncertainty]
indicando que	[uncertainty]
evaluado para	[uncertainty]
ningún cambio	[uncertainty]
probablemente	[uncertainty]
inconsistente	[uncertainty]
no improbable	[uncertainty]
sino más bien	[uncertainty]
se desconoce	[uncertainty]
sorprendente	[uncertainty]
en línea con	[uncertainty]
hipotetizado	[uncertainty]
especulación	[uncertainty]
sin aparente	[uncertainty]
no puede ser	[uncertainty]
generalmente	[uncertainty]
regularmente	[uncertainty]
incompatible	[uncertainty]
más bien que	[uncertainty]
inexplicable	[uncertainty]
posiblemente	[uncertainty]
identificado	[uncertainty]
sugestivo de	[uncertainty]
dudosamente	[uncertainty]
no evidente	[uncertainty]
posibilidad	[uncertainty]
implica que	[uncertainty]
apareciendo	[uncertainty]
no conocida	[uncertainty]
normalmente	[uncertainty]
supongo que	[uncertainty]
no es claro	[uncertainty]
contencioso	[uncertainty]
indican que	[uncertainty]
sospecha de	[uncertainty]
es probable	[uncertainty]
hipotetizar	[uncertainty]
sospecha de	[uncertainty]
indican que	[uncertainty]
no excluido	[uncertainty]
considerado	[uncertainty]
proponiendo	[uncertainty]
pensamiento	[uncertainty]
referirse a	[uncertainty]
descartaría	[uncertainty]
descartaria	[uncertainty]
es posible	[uncertainty]
ambigüedad	[uncertainty]
poco claro	[uncertainty]
valoración	[uncertainty]
implicando	[uncertainty]
sugiriendo	[uncertainty]
valoracion	[uncertainty]
investigar	[uncertainty]
incompleto	[uncertainty]
paradójico	[uncertainty]
improbable	[uncertainty]
parece que	[uncertainty]
compatible	[uncertainty]
descartada	[uncertainty]
inesperado	[uncertainty]
indicó eso	[uncertainty]
al parecer	[uncertainty]
descartado	[uncertainty]
no excluir	[uncertainty]
concebible	[uncertainty]
indica que	[uncertainty]
podría ser	[uncertainty]
insinuando	[uncertainty]
preliminar	[uncertainty]
considerar	[uncertainty]
actúa como	[uncertainty]
sospechosa	[uncertainty]
pienso que	[uncertainty]
sospechoso	[uncertainty]
sugestivos	[uncertainty]
suposición	[uncertainty]
sugerencia	[uncertainty]	
no tendria	[uncertainty]
no deberia	[uncertainty]
impresiona	[uncertainty]
con dudoso	[uncertainty]
con dudosa	[uncertainty]
contrario	[uncertainty]
potencial	[uncertainty]
me parece	[uncertainty]
imposible	[uncertainty]
probables	[uncertainty]
puede ser	[uncertainty]
se evalua	[uncertainty]
sospechar	[uncertainty]
hipótesis	[uncertainty]
sugestivo	[uncertainty]
esperanza	[uncertainty]
sugerente	[uncertainty]
asumiendo	[uncertainty]
indicando	[uncertainty]
raramente	[uncertainty]
aparentes	[uncertainty]
especular	[uncertainty]
no seguro	[uncertainty]
propuesta	[uncertainty]
postulado	[uncertainty]
sugestiva	[uncertainty]
sugestivo	[uncertainty]
sin claro	[uncertainty]
sospecha	[uncertainty]
aparecer	[uncertainty]
apunta a	[uncertainty]
polémico	[uncertainty]
paradoja	[uncertainty]
dudo que	[uncertainty]
no se si	[uncertainty]
no causa	[uncertainty]
sospecho	[uncertainty]
probable	[uncertainty]
apareció	[uncertainty]
incierto	[uncertainty]
ficticio	[uncertainty]
no drena	[uncertainty]
engañoso	[uncertainty]
predecir	[uncertainty]
aparente	[uncertainty]
indicado	[uncertainty]
eventual	[uncertainty]
consenso	[uncertainty]
supuesto	[uncertainty]
proponer	[uncertainty]
implicar	[uncertainty]
esperado	[uncertainty]
putativo	[uncertainty]
predicho	[uncertainty]
creo que	[uncertainty]
presunto	[uncertainty]
no puedo	[uncertainty]
sugieren	[uncertainty]
pudieran	[uncertainty]
posibles	[uncertainty]
ambiguo	[uncertainty]
no sabe	[uncertainty]
creemos	[uncertainty]
implica	[uncertainty]
predice	[uncertainty]
dudo de	[uncertainty]
posible	[uncertainty]
valorar	[uncertainty]
reporte	[uncertainty]
parecer	[uncertainty]
pudiera	[uncertainty]
apoyado	[uncertainty]
sugerir	[uncertainty]
confuso	[uncertainty]
debería	[uncertainty]
indican	[uncertainty]
disputa	[uncertainty]
suponer	[uncertainty]
tal vez	[uncertainty]
no pude	[uncertainty]
debería	[uncertainty]
si o no	[uncertainty]
estimar	[uncertainty]
sugiere	[uncertainty]
parecía	[uncertainty]
indicar	[uncertainty]
aparece	[uncertainty]
no solo	[uncertainty]
examina	[uncertainty]
sugirió	[uncertainty]
deberá	[uncertainty]
pensar	[uncertainty]
parece	[uncertainty]
creído	[uncertainty]
ya sea	[uncertainty]
quizás	[uncertainty]
viable	[uncertainty]
dudosa	[uncertainty]
podría	[uncertainty]
asumir	[uncertainty]
noción	[uncertainty]
quizás	[uncertainty]
podria	[uncertainty]
si se	[uncertainty]
quizá	[uncertainty]
sería	[uncertainty]
dudas	[uncertainty]
creer	[uncertainty]
puede	[uncertainty]
haría	[uncertainty]
pocos	[uncertainty]
podrá	[uncertainty]
quizá	[uncertainty]
raro	[uncertainty]
creo	[uncertainty]
debe	[uncertainty]
duda	[uncertainty]
será	[uncertainty]
y/o	[uncertainty]
vs	[uncertainty]
========================= Uncertainty Post ==================================
desconocido	[post-uncertainty]
desconocida	[post-uncertainty]
sospechoso	[post-uncertainty]
sospechosa	[post-uncertainty]
a valorar	[post-uncertainty]
dudoso	[post-uncertainty]
dudosa	[post-uncertainty]
============== Double negation Pre	===========================================
sin que se pueda descartar	[double-negation-pre]
con el fin de descartar	[double-negation-pre]
no pueden descartarse	[double-negation-pre]
sin poderse descartar	[double-negation-pre]
no se puede descartar	[double-negation-pre]
sin poder descartarse	[double-negation-pre]
sin poder descartarse	[double-negation-pre]
no permiten descartar	[double-negation-pre]
no permite descartar	[double-negation-pre]
no podemos descartar	[double-negation-pre]
no puede descartarse	[double-negation-pre]
sin poder descartar	[double-negation-pre]
no poder descartar	[double-negation-pre]
no es descartable	[double-negation-pre]
no descartandose	[double-negation-pre]
sin descartarse	[double-negation-pre]
para descartar	[double-negation-pre]
no descartable	[double-negation-pre]
no se descarta	[double-negation-pre]
sin descartar	[double-negation-pre]
no descartar	[double-negation-pre]
no obstante	[double-negation-pre]
sin embargo	[double-negation-pre]
si no	[double-negation-pre]
==============	Double negation Post	===========================================
falsos negativos	[double-negation-post]
falso negativo	[double-negation-post]
=============    Morfological Negation ============================================
asintomático	[morphological-negation]
asintomática	[morphological-negation]
asintomatico	[morphological-negation]
asintomatica	[morphological-negation]
afebril	[morphological-negation]
=====================	End file	===================================================